10x10* o12
***1******
*       **
* *  **  *
1        *
** ** ** *
*       **
*      ***
**       *
*        *
***2******
